1 1 1 5 5 5 5 5 1 1 1 1 1 1 1 1 1 1 1 1 1 1 1 1 1 1 1 1 1 1 1 1
1 1 1 5 5 5 5 5 2 2 1 1 1 1 2 2 2 2 1 1 1 1 5 5 5 5 1 2 2 2 1 1
1 1 1 5 5 5 5 5 2 2 1 1 1 1 2 2 2 2 1 1 1 1 5 5 5 5 1 2 2 2 1 1
1 1 1 1 1 1 1 1 1 1 1 1 1 1 2 2 2 2 1 1 1 1 5 5 5 5 1 1 1 1 4 4
1 1 1 1 1 1 1 1 1 1 1 1 1 1 1 1 1 1 1 1 1 1 1 1 1 1 1 1 1 1 4 4
1 1 1 1 1 1 1 1 1 1 1 1 1 1 1 1 1 1 1 1 1 1 1 1 1 1 1 1 1 1 4 4
1 1 1 1 1 1 1 1 1 1 1 1 1 1 1 1 1 1 1 1 1 1 1 1 1 1 1 1 1 1 1 1
0 0 1 1 1 1 1 1 1 1 1 1 1 1 1 1 1 1 1 1 1 1 1 1 1 1 1 1 1 1 1 1
0 0 0 0 1 1 1 1 1 1 1 1 1 1 1 1 1 1 1 1 1 1 1 1 1 1 1 1 1 1 1 1
1 0 0 0 0 0 1 1 1 1 1 1 1 1 1 1 1 1 1 1 1 1 1 1 1 1 1 1 1 1 1 1
1 1 1 0 0 0 0 0 1 1 1 1 1 1 1 1 1 1 2 2 2 1 1 1 1 1 1 1 1 1 1 1
1 1 1 1 1 0 0 0 0 0 0 1 1 1 1 1 1 1 2 2 2 1 1 1 1 1 1 1 1 1 1 1 
1 1 1 1 1 1 1 1 0 0 0 0 0 0 6 1 1 1 2 2 2 1 5 5 5 5 1 1 1 1 1 1
1 1 1 1 1 1 1 1 1 1 0 0 0 6 6 6 6 1 1 1 1 1 5 5 5 5 1 1 1 1 2 2
1 1 1 1 1 1 1 1 1 1 1 1 0 6 6 6 0 0 1 1 1 1 5 5 5 5 1 1 1 1 2 2
5 5 5 1 2 1 1 1 1 1 1 1 1 1 6 6 0 0 0 1 1 1 1 1 1 1 1 1 1 1 2 2
5 5 5 2 2 2 1 1 1 1 1 1 1 1 1 1 0 0 0 0 0 1 1 1 1 1 1 1 1 1 1 1
5 5 5 1 2 1 1 1 1 1 1 1 1 1 1 1 1 0 0 0 0 0 1 1 1 1 1 1 1 1 1 1
6
12 4
5 14
30 6
29 13
5 5
8 6
4
0 16 7
2 25 4
3 7 17
0 28 4
