1 1 1 5 5 5 5 5 1 1 1 1 1 1 1 1 1 1 1 1 1 1 1 1 1 1 1 1 1 1 1 1
1 1 1 5 5 5 5 5 2 2 1 1 1 1 2 2 2 2 1 1 1 1 5 5 5 5 1 2 2 2 1 1
1 1 1 5 5 5 5 5 2 2 1 1 1 1 2 2 2 2 1 1 1 1 5 5 5 5 1 2 2 2 1 1
1 1 1 1 1 1 1 1 1 1 1 1 1 1 2 2 2 2 1 1 1 1 5 5 5 5 1 1 1 1 4 4
1 1 1 1 1 1 1 1 1 1 1 1 1 1 1 1 1 1 1 1 1 1 1 1 1 1 1 1 1 1 4 4
1 1 1 1 1 1 1 1 1 1 1 1 1 1 1 1 1 1 1 1 1 2 2 1 1 1 1 1 1 1 4 4
1 1 1 1 1 1 1 1 1 1 1 1 2 2 2 1 1 1 1 1 2 2 2 2 1 1 1 1 1 1 1 1
0 0 1 1 1 1 1 1 1 1 1 2 2 2 2 2 1 1 1 1 1 2 2 1 1 1 1 1 1 1 1 1
0 0 0 0 1 1 1 1 1 1 1 1 2 2 2 1 1 1 1 1 1 1 1 1 1 1 1 1 1 1 1 1
1 0 0 0 0 0 1 1 1 1 1 1 1 1 1 1 1 1 1 1 1 1 1 1 1 1 1 1 1 1 1 1
1 1 1 0 0 0 0 0 1 1 1 1 1 1 1 1 1 1 2 2 2 1 1 1 1 1 1 1 1 1 1 1
1 1 1 1 1 0 0 0 0 0 0 1 1 1 1 1 1 1 2 2 2 1 1 1 1 1 1 1 1 1 1 1 
1 1 1 1 1 1 1 1 0 0 0 0 0 6 6 1 1 1 2 2 2 1 5 5 5 5 1 1 1 1 1 1
1 1 1 1 1 1 1 1 1 1 0 0 0 6 6 6 6 1 1 1 1 1 5 5 5 5 1 1 1 1 2 2
1 1 1 1 1 1 1 1 1 1 1 1 0 6 6 6 6 0 1 1 1 1 5 5 5 5 1 1 1 2 2 2
5 5 5 1 2 1 1 1 1 1 1 1 1 1 6 6 6 0 0 1 1 1 1 1 1 1 1 1 1 1 2 2
5 5 5 2 2 2 1 1 1 1 1 1 1 1 1 1 6 0 0 0 0 1 1 1 1 1 1 1 1 1 1 1
5 5 5 1 2 1 1 1 1 1 1 1 1 1 1 1 1 0 0 0 0 0 1 1 1 1 1 1 1 1 1 1
8
0 12 4
0 5 14
0 29 4
0 29 13
1 5 5
0 8 6
1 20 7
1 25 17
8
1 13 11 5
0 16 7 10
2 25 4 4
3 7 15 3
0 3 3 20
5 29 5 1
5 23 15 1
4 6 13 4
