1 1 1 2 2 1 1 1 1 1 1 1 1 2 2 2 2 2 1 1 1 1 1 2 2 1 1 1 1 1 1 1
1 1 1 2 2 1 1 1 1 1 1 1 1 2 2 1 1 1 1 1 1 1 1 2 2 1 1 1 1 1 1 1
1 1 1 2 2 2 2 2 1 1 1 1 1 2 2 1 1 1 1 2 2 1 1 2 2 2 2 2 1 1 1 1
2 1 1 1 1 2 2 2 1 1 1 1 1 2 2 1 1 1 1 2 2 1 1 1 1 1 2 2 1 1 1 1
2 1 1 1 1 2 2 2 1 1 1 1 1 2 2 1 1 1 1 2 2 1 1 1 1 1 2 2 1 1 1 4
2 1 1 1 1 2 2 2 1 1 1 1 1 2 2 1 1 1 1 2 2 1 1 1 1 1 2 2 1 1 1 4
2 1 1 1 1 1 1 1 1 1 1 1 1 1 1 1 1 1 1 2 2 1 1 1 1 1 1 1 1 1 1 4
2 1 1 1 1 1 1 1 1 1 1 1 1 1 1 1 1 1 1 2 2 1 1 1 1 1 1 1 1 1 1 1
2 2 2 1 1 1 1 2 2 1 1 2 1 1 1 2 1 1 1 2 2 1 1 1 1 2 2 2 2 1 1 1
2 2 2 1 1 1 1 2 2 1 1 2 1 1 1 2 1 1 1 1 1 1 1 1 1 2 2 2 2 1 1 1
2 2 2 1 1 1 1 2 2 1 1 2 1 1 1 2 1 1 1 1 1 1 1 1 1 1 1 1 1 1 1 1
2 2 2 1 1 1 1 2 2 1 1 2 1 1 1 2 1 1 1 1 1 1 1 1 1 1 1 1 1 1 1 1 
2 2 2 1 1 1 1 2 2 1 1 2 1 1 1 2 1 1 1 1 1 1 1 1 1 1 1 1 1 1 2 2
1 1 1 2 2 1 1 2 2 1 1 2 1 1 1 2 2 2 2 2 1 1 1 2 2 2 2 2 1 1 2 2
1 1 1 2 2 1 1 1 1 1 1 2 1 1 1 2 2 2 2 2 1 1 1 2 2 2 2 2 1 1 2 2
1 1 1 1 1 1 1 1 1 1 1 2 1 1 1 2 2 2 2 2 1 1 1 1 1 1 1 1 1 1 2 2
1 1 1 1 1 1 1 1 1 1 1 2 1 1 1 1 1 1 1 1 1 1 1 1 1 1 1 1 1 1 2 2
1 1 1 1 1 2 2 2 2 2 2 2 1 1 1 1 1 1 1 1 1 1 1 2 2 2 2 2 2 2 2 2
7
1 4 3
0 10 11
1 12 16
1 12 5
0 28 5
0 20 11
0 16 16
9
0 7 15 10
0 1 6 20
1 16 9 5
2 7 7 3
2 20 9 2
3 26 12 1
4 12 5 1
5 6 16 2 
5 28 10 1
